Key	Value
Key	Value
Stop	暂停
Playing	进行中
ReadTitle	批阅奏折
HaremTitle	后宫娱乐
TravelTitle	微服出行
ExtraChooseWifeTitle	主动选妃
ExtraChooseMinisterTitle	主动科举
AddMinisterTitle	提拔官员
ReduceMinisterTitle	降职官员
GiftTitle	赏赐
AddWifeTitle	封妃
ReduceWifeTitle	贬妃
MeetingTitle	主动上朝
FixedMeetingTitle	群臣上朝
ChooseWifeTitle	选妃活动
ChooseMinisterTitle	科举选臣
OutlanderAttackTitle	异族入侵
KingBirthDayTitle	君主生日
OtherBirthDayTitle	{0}生日
PeasantUprisingTitle	农民起义
GeneralsRebelTitle	将领反叛
IntroduceMinisterTitle	臣子举荐
QuitMinisterTitle	臣子辞官
MinisterMurderTitle	臣子暗杀
DelateMinisterTitle	臣子弹劾
ResearchAreaTitle	调查地区
ResearchMinisterTitle	调查官员
MurderTitle	谋杀
SeduceTitle	勾引
RobFoodTitle	搜刮钱财
ForgeGoodOmenTitle	伪造祥瑞
FindGoodOmenTitle	发现祥瑞
FindBadOmenTitle	发现噩兆
ForgeRumorTitle	散布谣言
CountryTaxRateTitle	国家税率
CountryArmyRateTitle	国家征兵
CombatCorruptionTitle	打击腐败
LifeStyleTitle	生活作风
CountyTaxRateTitle	地方税率
CountyArmyRateTitle	地方征兵
TryAddFoodTitle	巧立名目
SelfRecommendationTitle	贤者自荐
BuildCountyTitle	地方建设
ReadDesc	加威望，在自由行动期间主动发起，耗时1日
HaremDesc	加被临幸妃子生育可能，在自由行动期间主动发起，耗时1日
TravelDesc	加威望，了解民情，在自由行动期间主动发起，视距离消耗时间，微服出行时期会自动忽略活动。
ExtraChooseWifeDesc	耗钱，主动开始一场选妃
ExtraChooseMinisterDesc	耗钱，主动开始一场科举
AddMinisterDesc	耗威望，被提拔人才威望越低，耗威望越高。
ReduceMinisterDesc	耗威望，被降职官员威望越高，耗威望越高
GiftDesc	耗钱，加好感。
AddWifeDesc	指定特定非后宫女性为自己的妃子，根据好感身份不同，有不同的后果。
ReduceWifeDesc	指定特定妃子降身份，根据好感身份不同，有不同的后果。
MeetingDesc	主动发起上朝
FixedMeetingDesc	每月1日固定上朝，时间暂停
ChooseWifeDesc	每年一月十五举行，时间暂停
ChooseMinisterDesc	每年六月六日举行，时间暂停
OutlanderAttackDesc	暂定505入侵
KingBirthDayDesc	操办，耗钱，收官员礼物，礼物视官员家底，耗时1日
OtherBirthDayDesc	操办，耗钱，加好感。
PeasantUprisingDesc	民意长期处于负值，越低触发越高
GeneralsRebelDesc	忠心长期处于负值，越低触发越高
IntroduceMinisterDesc	有合适人选，在上朝时有概率
QuitMinisterDesc	忠心长期处于负值，越低触发越高
MinisterMurderDesc	平时有概率触发，党争
DelateMinisterDesc	上朝时有概率触发，党争
ResearchAreaDesc	指派一名人员，耗时七日。
ResearchMinisterDesc	指派一名人员，耗时七日。
MurderDesc	指派一名人员，耗时十五日，有失败风险，失败被发现会降低威望，降低忠诚。
SeduceDesc	耗钱，增加指定非后宫女性好感，耗时三日。
RobFoodDesc	指派一名人员，耗时十五日，被发现，减清官，减民忠诚。
ForgeGoodOmenDesc	指派一名人员，耗钱，耗时三十日，成功增加大量威望。
FindGoodOmenDesc	发现祥瑞
FindBadOmenDesc	发现噩兆
ForgeRumorDesc	指派一名人员对指定人员散布谣言，耗钱，耗时三十日，成功减少目标大量威望。
CountryTaxRateDesc	国家税率
CountryArmyRateDesc	国家征兵
CombatCorruptionDesc	打击腐败
LifeStyleDesc	生活作风
CountyTaxRateDesc	地方税率
CountyArmyRateDesc	地方征兵
TryAddFoodDesc	巧立名目
SelfRecommendationDesc	贤者自荐
BuildCountyDesc	地方建设
FoodCost	消耗{0}食物
CachetCost	消耗{0}威望
NeedTimeCost	耗时{0}天
ChooseExecutor	选择执行者
ChooseTarget	选择目标
NoCanChoose	无可用目标
Country	国家
King	皇上
Queen	皇后
Concubine	贵妃
Hetaera	才人
Prince	王子
Princess	公主
LPM	左丞相
RPM	右丞相
OfficeSS	吏部尚书
OfficeSL	吏部侍郎
HouseSS	户部尚书
HouseSL	户部侍郎
RiteSS	礼部尚书
RiteSL	礼部侍郎
ArmySS	兵部尚书
ArmySL	兵部侍郎
PenalSS	刑部尚书
PenalSL	刑部侍郎
WorkSS	工部尚书
WorkSL	工部侍郎
Officer	小吏
Manager	密探总管
Secret	密探
AgeDesc	年龄：
CachetDesc	威望：
AbilityDesc	能力：
LoyaltyDesc	忠诚：
CharacteristicDesc	特性：
PeopleNum	人民：
RemainFood	余粮：
ArmyNum	军队：
CorruptionRate	贪腐：
AreaFactor	经济：
Event	事件：
TaxDesc	税率：
ArmyRate	兵役：